This is the excel function data, in its final state before converting to python functions
for the excelbird.fn module.
We keep this in case of wanting to refactor the function design.
===========================================================================================================

abs :: ABS :: **Math and trigonometry:** :: Returns the absolute value of a number
accrint :: ACCRINT :: **Financial:** :: Returns the accrued interest for a security that pays periodic interest
accrintm :: ACCRINTM :: **Financial:** :: Returns the accrued interest for a security that pays interest at maturity
acos :: ACOS :: **Math and trigonometry:** :: Returns the arccosine of a number
acosh :: ACOSH :: **Math and trigonometry:** :: Returns the inverse hyperbolic cosine of a number
acot :: ACOT :: **Math and trigonometry:** :: Returns the arccotangent of a number
acoth :: ACOTH :: **Math and trigonometry:** :: Returns the hyperbolic arccotangent of a number
aggregate :: AGGREGATE :: **Math and trigonometry:** :: Returns an aggregate in a list or database
address :: ADDRESS :: **Lookup and reference:** :: Returns a reference as text to a single cell in a worksheet
amordegrc :: AMORDEGRC :: **Financial:** :: Returns the depreciation for each accounting period by using a depreciation coefficient
amorlinc :: AMORLINC :: **Financial:** :: Returns the depreciation for each accounting period
and :: AND :: **Logical:** :: Returns TRUE if all of its arguments are TRUE
arabic :: ARABIC :: **Math and trigonometry:** :: Converts a Roman number to Arabic, as a number
areas :: AREAS :: **Lookup and reference:** :: Returns the number of areas in a reference
arraytotext :: ARRAYTOTEXT :: **Text:** :: Returns an array of text values from any specified range
asc :: ASC :: **Text:** :: Changes full-width (double-byte) English letters or katakana within a character string to half-width (single-byte) characters
asin :: ASIN :: **Math and trigonometry:** :: Returns the arcsine of a number
asinh :: ASINH :: **Math and trigonometry:** :: Returns the inverse hyperbolic sine of a number
atan :: ATAN :: **Math and trigonometry:** :: Returns the arctangent of a number
atan2 :: ATAN2 :: **Math and trigonometry:** :: Returns the arctangent from x- and y-coordinates
atanh :: ATANH :: **Math and trigonometry:** :: Returns the inverse hyperbolic tangent of a number
avedev :: AVEDEV :: **Statistical:** :: Returns the average of the absolute deviations of data points from their mean
average :: AVERAGE :: **Statistical:** :: Returns the average of its arguments
averagea :: AVERAGEA :: **Statistical:** :: Returns the average of its arguments, including numbers, text, and logical values
averageif :: AVERAGEIF :: **Statistical:** :: Returns the average (arithmetic mean) of all the cells in a range that meet a given criteria
averageifs :: AVERAGEIFS :: **Statistical:** :: Returns the average (arithmetic mean) of all cells that meet multiple criteria.
bahttext :: BAHTTEXT :: **Text:** :: Converts a number to text, using the ÃŸ (baht) currency format
base :: BASE :: **Math and trigonometry:** :: Converts a number into a text representation with the given radix (base)
besseli :: BESSELI :: **Engineering:** :: Returns the modified Bessel function In(x)
besselj :: BESSELJ :: **Engineering:** :: Returns the Bessel function Jn(x)
besselk :: BESSELK :: **Engineering:** :: Returns the modified Bessel function Kn(x)
bessely :: BESSELY :: **Engineering:** :: Returns the Bessel function Yn(x)
betadist :: BETADIST :: **Compatibility:** :: Returns the beta cumulative distribution function
beta_dist :: BETA.DIST :: **Statistical:** :: Returns the beta cumulative distribution function
betainv :: BETAINV :: **Compatibility:** :: Returns the inverse of the cumulative distribution function for a specified beta distribution
beta_inv :: BETA.INV :: **Statistical:** :: Returns the inverse of the cumulative distribution function for a specified beta distribution
bin2dec :: BIN2DEC :: **Engineering:** :: Converts a binary number to decimal
bin2hex :: BIN2HEX :: **Engineering:** :: Converts a binary number to hexadecimal
bin2oct :: BIN2OCT :: **Engineering:** :: Converts a binary number to octal
binomdist :: BINOMDIST :: **Compatibility:** :: Returns the individual term binomial distribution probability
binom_dist :: BINOM.DIST :: **Statistical:** :: Returns the individual term binomial distribution probability
binom_dist_range :: BINOM.DIST.RANGE :: **Statistical:** :: Returns the probability of a trial result using a binomial distribution
binom_inv :: BINOM.INV :: **Statistical:** :: Returns the smallest value for which the cumulative binomial distribution is less than or equal to a criterion value
bitand :: BITAND :: **Engineering:** :: Returns a 'Bitwise And' of two numbers
bitlshift :: BITLSHIFT :: **Engineering:** :: Returns a value number shifted left by shift_amount bits
bitor :: BITOR :: **Engineering:** :: Returns a bitwise OR of 2 numbers
bitrshift :: BITRSHIFT :: **Engineering:** :: Returns a value number shifted right by shift_amount bits
bitxor :: BITXOR :: **Engineering:** :: Returns a bitwise 'Exclusive Or' of two numbers
bycol :: BYCOL :: **Logical:** :: Applies a LAMBDA to each column and returns an array of the results
byrow :: BYROW :: **Logical:** :: Applies a LAMBDA to each row and returns an array of the results
call :: CALL :: **Add-in and Automation:** :: Calls a procedure in a dynamic link library or code resource
ceiling :: CEILING :: **Compatibility:** :: Rounds a number to the nearest integer or to the nearest multiple of significance
ceiling_math :: CEILING.MATH :: **Math and trigonometry:** :: Rounds a number up, to the nearest integer or to the nearest multiple of significance
ceiling_precise :: CEILING.PRECISE :: **Math and trigonometry:** :: Rounds a number the nearest integer or to the nearest multiple of significance. Regardless of the sign of the number, the number is rounded up.
cell :: CELL :: **Information:** :: Returns information about the formatting, location, or contents of a cell
char :: CHAR :: **Text:** :: Returns the character specified by the code number
chidist :: CHIDIST :: **Compatibility:** :: Returns the one-tailed probability of the chi-squared distribution
chiinv :: CHIINV :: **Compatibility:** :: Returns the inverse of the one-tailed probability of the chi-squared distribution
chitest :: CHITEST :: **Compatibility:** :: Returns the test for independence
chisq_dist :: CHISQ.DIST :: **Statistical:** :: Returns the cumulative beta probability density function
chisq_dist_rt :: CHISQ.DIST.RT :: **Statistical:** :: Returns the one-tailed probability of the chi-squared distribution
chisq_inv :: CHISQ.INV :: **Statistical:** :: Returns the cumulative beta probability density function
chisq_inv_rt :: CHISQ.INV.RT :: **Statistical:** :: Returns the inverse of the one-tailed probability of the chi-squared distribution
chisq_test :: CHISQ.TEST :: **Statistical:** :: Returns the test for independence
choose :: CHOOSE :: **Lookup and reference:** :: Chooses a value from a list of values
choosecols :: CHOOSECOLS :: **Lookup and reference:** :: Returns the specified columns from an array
chooserows :: CHOOSEROWS :: **Lookup and reference:** :: Returns the specified rows from an array
clean :: CLEAN :: **Text:** :: Removes all nonprintable characters from text
code :: CODE :: **Text:** :: Returns a numeric code for the first character in a text string
column :: COLUMN :: **Lookup and reference:** :: Returns the column number of a reference
columns :: COLUMNS :: **Lookup and reference:** :: Returns the number of columns in a reference
combin :: COMBIN :: **Math and trigonometry:** :: Returns the number of combinations for a given number of objects
combina :: COMBINA :: **Engineering:** :: Converts real and imaginary coefficients into a complex number
concat :: CONCAT :: **Text:** :: Combines the text from multiple ranges and/or strings, but it doesn't provide the delimiter or IgnoreEmpty arguments.
concatenate :: CONCATENATE :: **Text:** :: Joins several text items into one text item
confidence :: CONFIDENCE :: **Compatibility:** :: Returns the confidence interval for a population mean
confidence_norm :: CONFIDENCE.NORM :: **Statistical:** :: Returns the confidence interval for a population mean
confidence_t :: CONFIDENCE.T :: **Statistical:** :: Returns the confidence interval for a population mean, using a Student's t distribution
convert :: CONVERT :: **Engineering:** :: Converts a number from one measurement system to another
correl :: CORREL :: **Statistical:** :: Returns the correlation coefficient between two data sets
cos :: COS :: **Math and trigonometry:** :: Returns the cosine of a number
cosh :: COSH :: **Math and trigonometry:** :: Returns the hyperbolic cosine of a number
cot :: COT :: **Math and trigonometry:** :: Returns the hyperbolic cosine of a number
coth :: COTH :: **Math and trigonometry:** :: Returns the cotangent of an angle
count :: COUNT :: **Statistical:** :: Counts how many numbers are in the list of arguments
counta :: COUNTA :: **Statistical:** :: Counts how many values are in the list of arguments
countblank :: COUNTBLANK :: **Statistical:** :: Counts the number of blank cells within a range
countif :: COUNTIF :: **Statistical:** :: Counts the number of cells within a range that meet the given criteria
countifs :: COUNTIFS :: **Statistical:** :: Counts the number of cells within a range that meet multiple criteria
coupdaybs :: COUPDAYBS :: **Financial:** :: Returns the number of days from the beginning of the coupon period to the settlement date
coupdays :: COUPDAYS :: **Financial:** :: Returns the number of days in the coupon period that contains the settlement date
coupdaysnc :: COUPDAYSNC :: **Financial:** :: Returns the number of days from the settlement date to the next coupon date
coupncd :: COUPNCD :: **Financial:** :: Returns the next coupon date after the settlement date
coupnum :: COUPNUM :: **Financial:** :: Returns the number of coupons payable between the settlement date and maturity date
couppcd :: COUPPCD :: **Financial:** :: Returns the previous coupon date before the settlement date
covar :: COVAR :: **Compatibility:** :: Returns covariance, the average of the products of paired deviations
covariance_p :: COVARIANCE.P :: **Statistical:** :: Returns covariance, the average of the products of paired deviations
covariance_s :: COVARIANCE.S :: **Statistical:** :: Returns the sample covariance, the average of the products deviations for each data point pair in two data sets
critbinom :: CRITBINOM :: **Compatibility:** :: Returns the smallest value for which the cumulative binomial distribution is less than or equal to a criterion value
csc :: CSC :: **Math and trigonometry:** :: Returns the cosecant of an angle
csch :: CSCH :: **Math and trigonometry:** :: Returns the hyperbolic cosecant of an angle
cubekpimember :: CUBEKPIMEMBER :: **Cube:** :: Returns a key performance indicator (KPI) name, property, and measure, and displays the name and property in the cell. A KPI is a quantifiable measurement, such as monthly gross profit or quarterly employee turnover, used to monitor an organization's performance.
cubemember :: CUBEMEMBER :: **Cube:** :: Returns a member or tuple in a cube hierarchy. Use to validate that the member or tuple exists in the cube.
cubememberproperty :: CUBEMEMBERPROPERTY :: **Cube:** :: Returns the value of a member property in the cube. Use to validate that a member name exists within the cube and to return the specified property for this member.
cuberankedmember :: CUBERANKEDMEMBER :: **Cube:** :: Returns the nth, or ranked, member in a set. Use to return one or more elements in a set, such as the top sales performer or top 10 students.
cubeset :: CUBESET :: **Cube:** :: Defines a calculated set of members or tuples by sending a set expression to the cube on the server, which creates the set, and then returns that set to Microsoft Office Excel.
cubesetcount :: CUBESETCOUNT :: **Cube:** :: Returns the number of items in a set.
cubevalue :: CUBEVALUE :: **Cube:** :: Returns an aggregated value from a cube.
cumipmt :: CUMIPMT :: **Financial:** :: Returns the cumulative interest paid between two periods
cumprinc :: CUMPRINC :: **Financial:** :: Returns the cumulative principal paid on a loan between two periods
date :: DATE :: **Date and time:** :: Returns the serial number of a particular date
datedif :: DATEDIF :: **Date and time:** :: Calculates the number of days, months, or years between two dates. This function is useful in formulas where you need to calculate an age.
datevalue :: DATEVALUE :: **Date and time:** :: Converts a date in the form of text to a serial number
daverage :: DAVERAGE :: **Database:** :: Returns the average of selected database entries
day :: DAY :: **Date and time:** :: Converts a serial number to a day of the month
days :: DAYS :: **Date and time:** :: Returns the number of days between two dates
days360 :: DAYS360 :: **Date and time:** :: Calculates the number of days between two dates based on a 360-day year
db :: DB :: **Financial:** :: Returns the depreciation of an asset for a specified period by using the fixed-declining balance method
dbcs :: DBCS :: **Text:** :: Changes half-width (single-byte) English letters or katakana within a character string to full-width (double-byte) characters
dcount :: DCOUNT :: **Database:** :: Counts the cells that contain numbers in a database
dcounta :: DCOUNTA :: **Database:** :: Counts nonblank cells in a database
ddb :: DDB :: **Financial:** :: Returns the depreciation of an asset for a specified period by using the double-declining balance method or some other method that you specify
dec2bin :: DEC2BIN :: **Engineering:** :: Converts a decimal number to binary
dec2hex :: DEC2HEX :: **Engineering:** :: Converts a decimal number to hexadecimal
dec2oct :: DEC2OCT :: **Engineering:** :: Converts a decimal number to octal
decimal :: DECIMAL :: **Math and trigonometry:** :: Converts a text representation of a number in a given base into a decimal number
degrees :: DEGREES :: **Math and trigonometry:** :: Converts radians to degrees
delta :: DELTA :: **Engineering:** :: Tests whether two values are equal
devsq :: DEVSQ :: **Statistical:** :: Returns the sum of squares of deviations
dget :: DGET :: **Database:** :: Extracts from a database a single record that matches the specified criteria
disc :: DISC :: **Financial:** :: Returns the discount rate for a security
dmax :: DMAX :: **Database:** :: Returns the maximum value from selected database entries
dmin :: DMIN :: **Database:** :: Returns the minimum value from selected database entries
dollar :: DOLLAR :: **Text:** :: Converts a number to text, using the $ (dollar) currency format
dollarde :: DOLLARDE :: **Financial:** :: Converts a dollar price, expressed as a fraction, into a dollar price, expressed as a decimal number
dollarfr :: DOLLARFR :: **Financial:** :: Converts a dollar price, expressed as a decimal number, into a dollar price, expressed as a fraction
dproduct :: DPRODUCT :: **Database:** :: Multiplies the values in a particular field of records that match the criteria in a database
drop :: DROP :: **Lookup and reference:** :: Excludes a specified number of rows or columns from the start or end of an array
dstdev :: DSTDEV :: **Database:** :: Estimates the standard deviation based on a sample of selected database entries
dstdevp :: DSTDEVP :: **Database:** :: Calculates the standard deviation based on the entire population of selected database entries
dsum :: DSUM :: **Database:** :: Adds the numbers in the field column of records in the database that match the criteria
duration :: DURATION :: **Financial:** :: Returns the annual duration of a security with periodic interest payments
dvar :: DVAR :: **Database:** :: Estimates variance based on a sample from selected database entries
dvarp :: DVARP :: **Database:** :: Calculates variance based on the entire population of selected database entries
edate :: EDATE :: **Date and time:** :: Returns the serial number of the date that is the indicated number of months before or after the start date
effect :: EFFECT :: **Financial:** :: Returns the effective annual interest rate
encodeurl :: ENCODEURL :: **Web:** :: Returns a URL-encoded string
eomonth :: EOMONTH :: **Date and time:** :: Returns the serial number of the last day of the month before or after a specified number of months
erf :: ERF :: **Engineering:** :: Returns the error function
erf_precise :: ERF.PRECISE :: **Engineering:** :: Returns the error function
erfc :: ERFC :: **Engineering:** :: Returns the complementary error function
erfc_precise :: ERFC.PRECISE :: **Engineering:** :: Returns the complementary ERF function integrated between x and infinity
error_type :: ERROR.TYPE :: **Information:** :: Returns a number corresponding to an error type
euroconvert :: EUROCONVERT :: **Add-in and Automation:** :: Converts a number to euros, converts a number from euros to a euro member currency, or converts a number from one euro member currency to another by using the euro as an intermediary (triangulation).
even :: EVEN :: **Math and trigonometry:** :: Rounds a number up to the nearest even integer
exact :: EXACT :: **Text:** :: Checks to see if two text values are identical
exp :: EXP :: **Math and trigonometry:** :: Returns <i class="ocpItalic">e</i> raised to the power of a given number
expand :: EXPAND :: **Lookup and reference:** :: Expands or pads an array to specified row and column dimensions
expon_dist :: EXPON.DIST :: **Statistical:** :: Returns the exponential distribution
expondist :: EXPONDIST :: **Compatibility:** :: Returns the exponential distribution
fact :: FACT :: **Math and trigonometry:** :: Returns the factorial of a number
factdouble :: FACTDOUBLE :: **Math and trigonometry:** :: Returns the double factorial of a number
false :: FALSE :: **Logical:** :: Returns the logical value FALSE
f_dist :: F.DIST :: **Statistical:** :: Returns the F probability distribution
fdist :: FDIST :: **Compatibility:** :: Returns the F probability distribution
f_dist_rt :: F.DIST.RT :: **Statistical:** :: Returns the F probability distribution
filter :: FILTER :: **Lookup and reference:** :: Filters a range of data based on criteria you define
filterxml :: FILTERXML :: **Web:** :: Returns specific data from the XML content by using the specified XPath
find :: FIND :: **Text:** :: Finds one text value within another (case-sensitive)
findb :: FINDB :: **Text:** :: Finds one text value within another (case-sensitive)
f_inv :: F.INV :: **Statistical:** :: Returns the inverse of the F probability distribution
f_inv_rt :: F.INV.RT :: **Statistical:** :: Returns the inverse of the F probability distribution
finv :: FINV :: **Compatibility:** :: Returns the inverse of the F probability distribution
fisher :: FISHER :: **Statistical:** :: Returns the Fisher transformation
fisherinv :: FISHERINV :: **Statistical:** :: Returns the inverse of the Fisher transformation
fixed :: FIXED :: **Text:** :: Formats a number as text with a fixed number of decimals
floor :: FLOOR :: **Compatibility:** :: Rounds a number down, toward zero
floor_math :: FLOOR.MATH :: **Math and trigonometry:** :: Rounds a number down, to the nearest integer or to the nearest multiple of significance
floor_precise :: FLOOR.PRECISE :: **Math and trigonometry:** :: Rounds a number the nearest integer or to the nearest multiple of significance. Regardless of the sign of the number, the number is rounded up.
forecast :: FORECAST :: **Statistical:** :: Returns a value along a linear trend
formulatext :: FORMULATEXT :: **Lookup and reference:** :: Returns the formula at the given reference as text
frequency :: FREQUENCY :: **Statistical:** :: Returns a frequency distribution as a vertical array
f_test :: F.TEST :: **Statistical:** :: Returns the result of an F-test
ftest :: FTEST :: **Compatibility:** :: Returns the result of an F-test
fv :: FV :: **Financial:** :: Returns the future value of an investment
fvschedule :: FVSCHEDULE :: **Financial:** :: Returns the future value of an initial principal after applying a series of compound interest rates
gamma :: GAMMA :: **Statistical:** :: Returns the Gamma function value
gamma_dist :: GAMMA.DIST :: **Statistical:** :: Returns the gamma distribution
gammadist :: GAMMADIST :: **Compatibility:** :: Returns the gamma distribution
gamma_inv :: GAMMA.INV :: **Statistical:** :: Returns the inverse of the gamma cumulative distribution
gammainv :: GAMMAINV :: **Compatibility:** :: Returns the inverse of the gamma cumulative distribution
gammaln :: GAMMALN :: **Statistical:** :: Returns the natural logarithm of the gamma function, Î“(x)
gammaln_precise :: GAMMALN.PRECISE :: **Statistical:** :: Returns the natural logarithm of the gamma function, Î“(x)
gauss :: GAUSS :: **Statistical:** :: Returns 0.5 less than the standard normal cumulative distribution
gcd :: GCD :: **Math and trigonometry:** :: Returns the greatest common divisor
geomean :: GEOMEAN :: **Statistical:** :: Returns the geometric mean
gestep :: GESTEP :: **Engineering:** :: Tests whether a number is greater than a threshold value
getpivotdata :: GETPIVOTDATA :: **Lookup and reference:** :: Returns data stored in a PivotTable report
growth :: GROWTH :: **Statistical:** :: Returns values along an exponential trend
harmean :: HARMEAN :: **Statistical:** :: Returns the harmonic mean
hex2bin :: HEX2BIN :: **Engineering:** :: Converts a hexadecimal number to binary
hex2dec :: HEX2DEC :: **Engineering:** :: Converts a hexadecimal number to decimal
hex2oct :: HEX2OCT :: **Engineering:** :: Converts a hexadecimal number to octal
hlookup :: HLOOKUP :: **Lookup and reference:** :: Looks in the top row of an array and returns the value of the indicated cell
hour :: HOUR :: **Date and time:** :: Converts a serial number to an hour
hstack :: HSTACK :: **Lookup and reference:** :: Appends arrays horizontally and in sequence to return a larger array
hyperlink :: HYPERLINK :: **Lookup and reference:** :: Creates a shortcut or jump that opens a document stored on a network server, an intranet, or the Internet
hypgeom_dist :: HYPGEOM.DIST :: **Statistical:** :: Returns the hypergeometric distribution
hypgeomdist :: HYPGEOMDIST :: **Compatibility:** :: Returns the hypergeometric distribution
if :: IF :: **Logical:** :: Specifies a logical test to perform
iferror :: IFERROR :: **Logical:** :: Returns a value you specify if a formula evaluates to an error; otherwise, returns the result of the formula
ifna :: IFNA :: **Logical:** :: Returns the value you specify if the expression resolves to #N/A, otherwise returns the result of the expression
ifs :: IFS :: **Logical:** :: Checks whether one or more conditions are met and returns a value that corresponds to the first TRUE condition.
imabs :: IMABS :: **Engineering:** :: Returns the absolute value (modulus) of a complex number
imaginary :: IMAGINARY :: **Engineering:** :: Returns the imaginary coefficient of a complex number
imargument :: IMARGUMENT :: **Engineering:** :: Returns the argument theta, an angle expressed in radians
imconjugate :: IMCONJUGATE :: **Engineering:** :: Returns the complex conjugate of a complex number
imcos :: IMCOS :: **Engineering:** :: Returns the cosine of a complex number
imcosh :: IMCOSH :: **Engineering:** :: Returns the hyperbolic cosine of a complex number
imcot :: IMCOT :: **Engineering:** :: Returns the cotangent of a complex number
imcsc :: IMCSC :: **Engineering:** :: Returns the cosecant of a complex number
imcsch :: IMCSCH :: **Engineering:** :: Returns the hyperbolic cosecant of a complex number
imdiv :: IMDIV :: **Engineering:** :: Returns the quotient of two complex numbers
imexp :: IMEXP :: **Engineering:** :: Returns the exponential of a complex number
imln :: IMLN :: **Engineering:** :: Returns the natural logarithm of a complex number
imlog10 :: IMLOG10 :: **Engineering:** :: Returns the base-10 logarithm of a complex number
imlog2 :: IMLOG2 :: **Engineering:** :: Returns the base-2 logarithm of a complex number
impower :: IMPOWER :: **Engineering:** :: Returns a complex number raised to an integer power
improduct :: IMPRODUCT :: **Engineering:** :: Returns the product of complex numbers
imreal :: IMREAL :: **Engineering:** :: Returns the real coefficient of a complex number
imsec :: IMSEC :: **Engineering:** :: Returns the secant of a complex number
imsech :: IMSECH :: **Engineering:** :: Returns the hyperbolic secant of a complex number
imsin :: IMSIN :: **Engineering:** :: Returns the sine of a complex number
imsinh :: IMSINH :: **Engineering:** :: Returns the hyperbolic sine of a complex number
imsqrt :: IMSQRT :: **Engineering:** :: Returns the square root of a complex number
imsub :: IMSUB :: **Engineering:** :: Returns the difference between two complex numbers
imsum :: IMSUM :: **Engineering:** :: Returns the sum of complex numbers
imtan :: IMTAN :: **Engineering:** :: Returns the tangent of a complex number
index :: INDEX :: **Lookup and reference:** :: Uses an index to choose a value from a reference or array
indirect :: INDIRECT :: **Lookup and reference:** :: Returns a reference indicated by a text value
info :: INFO :: **Information:** :: Returns information about the current operating environment
int :: INT :: **Math and trigonometry:** :: Rounds a number down to the nearest integer
intercept :: INTERCEPT :: **Statistical:** :: Returns the intercept of the linear regression line
intrate :: INTRATE :: **Financial:** :: Returns the interest rate for a fully invested security
ipmt :: IPMT :: **Financial:** :: Returns the interest payment for an investment for a given period
irr :: IRR :: **Financial:** :: Returns the internal rate of return for a series of cash flows
isblank :: ISBLANK :: **Information:** :: Returns TRUE if the value is blank
iserr :: ISERR :: **Information:** :: Returns TRUE if the value is any error value except #N/A
iserror :: ISERROR :: **Information:** :: Returns TRUE if the value is any error value
iseven :: ISEVEN :: **Information:** :: Returns TRUE if the number is even
isformula :: ISFORMULA :: **Information:** :: Returns TRUE if there is a reference to a cell that contains a formula
islogical :: ISLOGICAL :: **Information:** :: Returns TRUE if the value is a logical value
isna :: ISNA :: **Information:** :: Returns TRUE if the value is the #N/A error value
isnontext :: ISNONTEXT :: **Information:** :: Returns TRUE if the value is not text
isnumber :: ISNUMBER :: **Information:** :: Returns TRUE if the value is a number
isodd :: ISODD :: **Information:** :: Returns TRUE if the number is odd
isomitted :: ISOMITTED :: **Information:** :: Checks whether the value in a LAMBDA is missing and returns TRUE or FALSE
isref :: ISREF :: **Information:** :: Returns TRUE if the value is a reference
istext :: ISTEXT :: **Information:** :: Returns TRUE if the value is text
iso_ceiling :: ISO.CEILING :: **Math and trigonometry:** :: Returns a number that is rounded up to the nearest integer or to the nearest multiple of significance
isoweeknum :: ISOWEEKNUM :: **Date and time:** :: Returns the number of the ISO week number of the year for a given date
ispmt :: ISPMT :: **Financial:** :: Calculates the interest paid during a specific period of an investment
jis :: JIS :: **Text:** :: Changes half-width (single-byte) characters within a string to full-width (double-byte) characters
kurt :: KURT :: **Statistical:** :: Returns the kurtosis of a data set
lambda :: LAMBDA :: **Logical:** :: Create custom, reusable functions and call them by a friendly name
large :: LARGE :: **Statistical:** :: Returns the k-th largest value in a data set
lcm :: LCM :: **Math and trigonometry:** :: Returns the least common multiple
left :: LEFT :: **Text:** :: Returns the leftmost characters from a text value
leftb :: LEFTB :: **Text:** :: Returns the leftmost characters from a text value
len :: LEN :: **Text:** :: Returns the number of characters in a text string
lenb :: LENB :: **Text:** :: Returns the number of characters in a text string
let :: LET :: **Logical:** :: Assigns names to calculation results
linest :: LINEST :: **Statistical:** :: Returns the parameters of a linear trend
ln :: LN :: **Math and trigonometry:** :: Returns the natural logarithm of a number
log :: LOG :: **Math and trigonometry:** :: Returns the logarithm of a number to a specified base
log10 :: LOG10 :: **Math and trigonometry:** :: Returns the base-10 logarithm of a number
logest :: LOGEST :: **Statistical:** :: Returns the parameters of an exponential trend
loginv :: LOGINV :: **Compatibility:** :: Returns the inverse of the lognormal cumulative distribution
lognorm_dist :: LOGNORM.DIST :: **Statistical:** :: Returns the cumulative lognormal distribution
lognormdist :: LOGNORMDIST :: **Compatibility:** :: Returns the cumulative lognormal distribution
lognorm_inv :: LOGNORM.INV :: **Statistical:** :: Returns the inverse of the lognormal cumulative distribution
lookup :: LOOKUP :: **Lookup and reference:** :: Looks up values in a vector or array
lower :: LOWER :: **Text:** :: Converts text to lowercase
makearray :: MAKEARRAY :: **Logical:** :: Returns a calculated array of a specified row and column size, by applying a LAMBDA
map :: MAP :: **Logical:** :: Returns an array formed by mapping each value in the array(s) to a new value by applying a LAMBDA to create a new value
match :: MATCH :: **Lookup and reference:** :: Looks up values in a reference or array
max :: MAX :: **Statistical:** :: Returns the maximum value in a list of arguments
maxa :: MAXA :: **Statistical:** :: Returns the maximum value in a list of arguments, including numbers, text, and logical values
maxifs :: MAXIFS :: **Statistical:** :: Returns the maximum value among cells specified by a given set of conditions or criteria
mdeterm :: MDETERM :: **Math and trigonometry:** :: Returns the matrix determinant of an array
mduration :: MDURATION :: **Financial:** :: Returns the Macauley modified duration for a security with an assumed par value of $100
median :: MEDIAN :: **Statistical:** :: Returns the median of the given numbers
mid :: MID :: **Text:** :: Returns a specific number of characters from a text string starting at the position you specify
midb :: MIDB :: **Text:** :: Returns a specific number of characters from a text string starting at the position you specify
min :: MIN :: **Statistical:** :: Returns the minimum value in a list of arguments
minifs :: MINIFS :: **Statistical:** :: Returns the minimum value among cells specified by a given set of conditions or criteria.
mina :: MINA :: **Statistical:** :: Returns the smallest value in a list of arguments, including numbers, text, and logical values
minute :: MINUTE :: **Date and time:** :: Converts a serial number to a minute
minverse :: MINVERSE :: **Math and trigonometry:** :: Returns the matrix inverse of an array
mirr :: MIRR :: **Financial:** :: Returns the internal rate of return where positive and negative cash flows are financed at different rates
mmult :: MMULT :: **Math and trigonometry:** :: Returns the matrix product of two arrays
mod :: MOD :: **Math and trigonometry:** :: Returns the remainder from division
mode :: MODE :: **Compatibility:** :: Returns the most common value in a data set
mode_mult :: MODE.MULT :: **Statistical:** :: Returns a vertical array of the most frequently occurring, or repetitive values in an array or range of data
mode_sngl :: MODE.SNGL :: **Statistical:** :: Returns the most common value in a data set
month :: MONTH :: **Date and time:** :: Converts a serial number to a month
mround :: MROUND :: **Math and trigonometry:** :: Returns a number rounded to the desired multiple
multinomial :: MULTINOMIAL :: **Math and trigonometry:** :: Returns the multinomial of a set of numbers
munit :: MUNIT :: **Math and trigonometry:** :: Returns the unit matrix or the specified dimension
n :: N :: **Information:** :: Returns a value converted to a number
na :: NA :: **Information:** :: Returns the error value #N/A
negbinom_dist :: NEGBINOM.DIST :: **Statistical:** :: Returns the negative binomial distribution
negbinomdist :: NEGBINOMDIST :: **Compatibility:** :: Returns the negative binomial distribution
networkdays :: NETWORKDAYS :: **Date and time:** :: Returns the number of whole workdays between two dates
networkdays_intl :: NETWORKDAYS.INTL :: **Date and time:** :: Returns the number of whole workdays between two dates using parameters to indicate which and how many days are weekend days
nominal :: NOMINAL :: **Financial:** :: Returns the annual nominal interest rate
norm_dist :: NORM.DIST :: **Statistical:** :: Returns the normal cumulative distribution
normdist :: NORMDIST :: **Compatibility:** :: Returns the normal cumulative distribution
norminv :: NORMINV :: **Statistical:** :: Returns the inverse of the normal cumulative distribution
norm_inv :: NORM.INV :: **Compatibility:** :: Returns the inverse of the normal cumulative distribution
norm_s_dist :: NORM.S.DIST :: **Statistical:** :: Returns the standard normal cumulative distribution
normsdist :: NORMSDIST :: **Compatibility:** :: Returns the standard normal cumulative distribution
norm_s_inv :: NORM.S.INV :: **Statistical:** :: Returns the inverse of the standard normal cumulative distribution
normsinv :: NORMSINV :: **Compatibility:** :: Returns the inverse of the standard normal cumulative distribution
not :: NOT :: **Logical:** :: Reverses the logic of its argument
now :: NOW :: **Date and time:** :: Returns the serial number of the current date and time
nper :: NPER :: **Financial:** :: Returns the number of periods for an investment
npv :: NPV :: **Financial:** :: Returns the net present value of an investment based on a series of periodic cash flows and a discount rate
numbervalue :: NUMBERVALUE :: **Text:** :: Converts text to number in a locale-independent manner
oct2bin :: OCT2BIN :: **Engineering:** :: Converts an octal number to binary
oct2dec :: OCT2DEC :: **Engineering:** :: Converts an octal number to decimal
oct2hex :: OCT2HEX :: **Engineering:** :: Converts an octal number to hexadecimal
odd :: ODD :: **Math and trigonometry:** :: Rounds a number up to the nearest odd integer
oddfprice :: ODDFPRICE :: **Financial:** :: Returns the price per $100 face value of a security with an odd first period
oddfyield :: ODDFYIELD :: **Financial:** :: Returns the yield of a security with an odd first period
oddlprice :: ODDLPRICE :: **Financial:** :: Returns the price per $100 face value of a security with an odd last period
oddlyield :: ODDLYIELD :: **Financial:** :: Returns the yield of a security with an odd last period
offset :: OFFSET :: **Lookup and reference:** :: Returns a reference offset from a given reference
or :: OR :: **Logical:** :: Returns TRUE if any argument is TRUE
pduration :: PDURATION :: **Financial:** :: Returns the number of periods required by an investment to reach a specified value
pearson :: PEARSON :: **Statistical:** :: Returns the Pearson product moment correlation coefficient
percentile_exc :: PERCENTILE.EXC :: **Statistical:** :: Returns the k-th percentile of values in a range, where k is in the range 0..1, exclusive
percentile_inc :: PERCENTILE.INC :: **Statistical:** :: Returns the k-th percentile of values in a range
percentile :: PERCENTILE :: **Compatibility:** :: Returns the k-th percentile of values in a range
percentrank_exc :: PERCENTRANK.EXC :: **Statistical:** :: Returns the rank of a value in a data set as a percentage (0..1, exclusive) of the data set
percentrank_inc :: PERCENTRANK.INC :: **Statistical:** :: Returns the percentage rank of a value in a data set
percentrank :: PERCENTRANK :: **Compatibility:** :: Returns the percentage rank of a value in a data set
permut :: PERMUT :: **Statistical:** :: Returns the number of permutations for a given number of objects
permutationa :: PERMUTATIONA :: **Statistical:** :: Returns the number of permutations for a given number of objects (with repetitions) that can be selected from the total objects
phi :: PHI :: **Statistical:** :: Returns the value of the density function for a standard normal distribution
phonetic :: PHONETIC :: **Text:** :: Extracts the phonetic (furigana) characters from a text string
pi :: PI :: **Math and trigonometry:** :: Returns the value of pi
pmt :: PMT :: **Financial:** :: Returns the periodic payment for an annuity
poisson_dist :: POISSON.DIST :: **Statistical:** :: Returns the Poisson distribution
poisson :: POISSON :: **Compatibility:** :: Returns the Poisson distribution
power :: POWER :: **Math and trigonometry:** :: Returns the result of a number raised to a power
ppmt :: PPMT :: **Financial:** :: Returns the payment on the principal for an investment for a given period
price :: PRICE :: **Financial:** :: Returns the price per $100 face value of a security that pays periodic interest
pricedisc :: PRICEDISC :: **Financial:** :: Returns the price per $100 face value of a discounted security
pricemat :: PRICEMAT :: **Financial:** :: Returns the price per $100 face value of a security that pays interest at maturity
prob :: PROB :: **Statistical:** :: Returns the probability that values in a range are between two limits
product :: PRODUCT :: **Math and trigonometry:** :: Multiplies its arguments
proper :: PROPER :: **Text:** :: Capitalizes the first letter in each word of a text value
pv :: PV :: **Financial:** :: Returns the present value of an investment
quartile :: QUARTILE :: **Compatibility:** :: Returns the quartile of a data set
quartile_exc :: QUARTILE.EXC :: **Statistical:** :: Returns the quartile of the data set, based on percentile values from 0..1, exclusive
quartile_inc :: QUARTILE.INC :: **Statistical:** :: Returns the quartile of a data set
quotient :: QUOTIENT :: **Math and trigonometry:** :: Returns the integer portion of a division
radians :: RADIANS :: **Math and trigonometry:** :: Converts degrees to radians
rand :: RAND :: **Math and trigonometry:** :: Returns a random number between 0 and 1
randarray :: RANDARRAY :: **Math and trigonometry:** :: Returns an array of random numbers between 0 and 1. However, you can specify the number of rows and columns to fill, minimum and maximum values, and whether to return whole numbers or decimal values.
randbetween :: RANDBETWEEN :: **Math and trigonometry:** :: Returns a random number between the numbers you specify
rank_avg :: RANK.AVG :: **Statistical:** :: Returns the rank of a number in a list of numbers
rank_eq :: RANK.EQ :: **Statistical:** :: Returns the rank of a number in a list of numbers
rank :: RANK :: **Compatibility:** :: Returns the rank of a number in a list of numbers
rate :: RATE :: **Financial:** :: Returns the interest rate per period of an annuity
received :: RECEIVED :: **Financial:** :: Returns the amount received at maturity for a fully invested security
reduce :: REDUCE :: **Logical:** :: Reduces an array to an accumulated value by applying a LAMBDA to each value and returning the total value in the accumulator
register_id :: REGISTER.ID :: **Add-in and Automation:** :: Returns the register ID of the specified dynamic link library (DLL) or code resource that has been previously registered
replace :: REPLACE :: **Text:** :: Replaces characters within text
replaceb :: REPLACEB :: **Text:** :: Replaces characters within text
rept :: REPT :: **Text:** :: Repeats text a given number of times
right :: RIGHT :: **Text:** :: Returns the rightmost characters from a text value
rightb :: RIGHTB :: **Text:** :: Returns the rightmost characters from a text value
roman :: ROMAN :: **Math and trigonometry:** :: Converts an arabic numeral to roman, as text
round :: ROUND :: **Math and trigonometry:** :: Rounds a number to a specified number of digits
rounddown :: ROUNDDOWN :: **Math and trigonometry:** :: Rounds a number down, toward zero
roundup :: ROUNDUP :: **Math and trigonometry:** :: Rounds a number up, away from zero
row :: ROW :: **Lookup and reference:** :: Returns the row number of a reference
rows :: ROWS :: **Lookup and reference:** :: Returns the number of rows in a reference
rri :: RRI :: **Financial:** :: Returns an equivalent interest rate for the growth of an investment
rsq :: RSQ :: **Statistical:** :: Returns the square of the Pearson product moment correlation coefficient
rtd :: RTD :: **Lookup and reference:** :: Retrieves real-time data from a program that supports COM automation
scan :: SCAN :: **Logical:** :: Scans an array by applying a LAMBDA to each value and returns an array that has each intermediate value
search :: SEARCH :: **Text:** :: Finds one text value within another (not case-sensitive)
searchb :: SEARCHB :: **Text:** :: Finds one text value within another (not case-sensitive)
sec :: SEC :: **Math and trigonometry:** :: Returns the secant of an angle
sech :: SECH :: **Math and trigonometry:** :: Returns the hyperbolic secant of an angle
second :: SECOND :: **Date and time:** :: Converts a serial number to a second
sequence :: SEQUENCE :: **Math and trigonometry:** :: Generates a list of sequential numbers in an array, such as 1, 2, 3, 4
seriessum :: SERIESSUM :: **Math and trigonometry:** :: Returns the sum of a power series based on the formula
sheet :: SHEET :: **Information:** :: Returns the sheet number of the referenced sheet
sheets :: SHEETS :: **Information:** :: Returns the number of sheets in a reference
sign :: SIGN :: **Math and trigonometry:** :: Returns the sign of a number
sin :: SIN :: **Math and trigonometry:** :: Returns the sine of the given angle
sinh :: SINH :: **Math and trigonometry:** :: Returns the hyperbolic sine of a number
skew :: SKEW :: **Statistical:** :: Returns the skewness of a distribution
skew_p :: SKEW.P :: **Statistical:** :: Returns the skewness of a distribution based on a population: a characterization of the degree of asymmetry of a distribution around its mean
sln :: SLN :: **Financial:** :: Returns the straight-line depreciation of an asset for one period
slope :: SLOPE :: **Statistical:** :: Returns the slope of the linear regression line
small :: SMALL :: **Statistical:** :: Returns the k-th smallest value in a data set
sort :: SORT :: **Lookup and reference:** :: Sorts the contents of a range or array
sortby :: SORTBY :: **Lookup and reference:** :: Sorts the contents of a range or array based on the values in a corresponding range or array
sqrt :: SQRT :: **Math and trigonometry:** :: Returns a positive square root
sqrtpi :: SQRTPI :: **Math and trigonometry:** :: Returns the square root of (number * pi)
standardize :: STANDARDIZE :: **Statistical:** :: Returns a normalized value
stockhistory :: STOCKHISTORY :: **Financial:** :: Retrieves historical data about a financial instrument
stdev :: STDEV :: **Compatibility:** :: Estimates standard deviation based on a sample
stdev_p :: STDEV.P :: **Statistical:** :: Calculates standard deviation based on the entire population
stdev_s :: STDEV.S :: **Statistical:** :: Estimates standard deviation based on a sample
stdeva :: STDEVA :: **Statistical:** :: Estimates standard deviation based on a sample, including numbers, text, and logical values
stdevp :: STDEVP :: **Compatibility:** :: Calculates standard deviation based on the entire population
stdevpa :: STDEVPA :: **Statistical:** :: Calculates standard deviation based on the entire population, including numbers, text, and logical values
steyx :: STEYX :: **Statistical:** :: Returns the standard error of the predicted y-value for each x in the regression
substitute :: SUBSTITUTE :: **Text:** :: Substitutes new text for old text in a text string
subtotal :: SUBTOTAL :: **Math and trigonometry:** :: Returns a subtotal in a list or database
sum :: SUM :: **Math and trigonometry:** :: Adds its arguments
sumif :: SUMIF :: **Math and trigonometry:** :: Adds the cells specified by a given criteria
sumifs :: SUMIFS :: **Math and trigonometry:** :: Adds the cells in a range that meet multiple criteria
sumproduct :: SUMPRODUCT :: **Math and trigonometry:** :: Returns the sum of the products of corresponding array components
sumsq :: SUMSQ :: **Math and trigonometry:** :: Returns the sum of the squares of the arguments
sumx2my2 :: SUMX2MY2 :: **Math and trigonometry:** :: Returns the sum of the difference of squares of corresponding values in two arrays
sumx2py2 :: SUMX2PY2 :: **Math and trigonometry:** :: Returns the sum of the sum of squares of corresponding values in two arrays
sumxmy2 :: SUMXMY2 :: **Math and trigonometry:** :: Returns the sum of squares of differences of corresponding values in two arrays
switch :: SWITCH :: **Logical:** :: Evaluates an expression against a list of values and returns the result corresponding to the first matching value. If there is no match, an optional default value may be returned.
syd :: SYD :: **Financial:** :: Returns the sum-of-years' digits depreciation of an asset for a specified period
t :: T :: **Text:** :: Converts its arguments to text
tan :: TAN :: **Math and trigonometry:** :: Returns the tangent of a number
tanh :: TANH :: **Math and trigonometry:** :: Returns the hyperbolic tangent of a number
take :: TAKE :: **Lookup and reference:** :: Returns a specified number of contiguous rows or columns from the start or end of an array
tbilleq :: TBILLEQ :: **Financial:** :: Returns the bond-equivalent yield for a Treasury bill
tbillprice :: TBILLPRICE :: **Financial:** :: Returns the price per $100 face value for a Treasury bill
tbillyield :: TBILLYIELD :: **Financial:** :: Returns the yield for a Treasury bill
t_dist :: T.DIST :: **Statistical:** :: Returns the Percentage Points (probability) for the Student t-distribution
t_dist_2t :: T.DIST.2T :: **Statistical:** :: Returns the Percentage Points (probability) for the Student t-distribution
t_dist_rt :: T.DIST.RT :: **Statistical:** :: Returns the Student's t-distribution
tdist :: TDIST :: **Compatibility:** :: Returns the Student's t-distribution
text :: TEXT :: **Text:** :: Formats a number and converts it to text
textafter :: TEXTAFTER :: **Text:** :: Returns text that occurs after given character or string
textbefore :: TEXTBEFORE :: **Text:** :: Returns text that occurs before a given character or string
textjoin :: TEXTJOIN :: **Text:** :: Combines the text from multiple ranges and/or strings
textsplit :: TEXTSPLIT :: **Text:** :: Splits text strings by using column and row delimiters
time :: TIME :: **Date and time:** :: Returns the serial number of a particular time
timevalue :: TIMEVALUE :: **Date and time:** :: Converts a time in the form of text to a serial number
t_inv :: T.INV :: **Statistical:** :: Returns the t-value of the Student's t-distribution as a function of the probability and the degrees of freedom
t_inv_2t :: T.INV.2T :: **Statistical:** :: Returns the inverse of the Student's t-distribution
tinv :: TINV :: **Compatibility:** :: Returns the inverse of the Student's t-distribution
tocol :: TOCOL :: **Lookup and reference:** :: Returns the array in a single column
torow :: TOROW :: **Lookup and reference:** :: Returns the array in a single row
today :: TODAY :: **Date and time:** :: Returns the serial number of today's date
transpose :: TRANSPOSE :: **Lookup and reference:** :: Returns the transpose of an array
trend :: TREND :: **Statistical:** :: Returns values along a linear trend
trim :: TRIM :: **Text:** :: Removes spaces from text
trimmean :: TRIMMEAN :: **Statistical:** :: Returns the mean of the interior of a data set
true :: TRUE :: **Logical:** :: Returns the logical value TRUE
trunc :: TRUNC :: **Math and trigonometry:** :: Truncates a number to an integer
t_test :: T.TEST :: **Statistical:** :: Returns the probability associated with a Student's t-test
ttest :: TTEST :: **Compatibility:** :: Returns the probability associated with a Student's t-test
type :: TYPE :: **Information:** :: Returns a number indicating the data type of a value
unichar :: UNICHAR :: **Text:** :: Returns the Unicode character that is references by the given numeric value
unicode :: UNICODE :: **Text:** :: Returns the number (code point) that corresponds to the first character of the text
unique :: UNIQUE :: **Lookup and reference:** :: Returns a list of unique values in a list or range
upper :: UPPER :: **Text:** :: Converts text to uppercase
value :: VALUE :: **Text:** :: Converts a text argument to a number
valuetotext :: VALUETOTEXT :: **Text:** :: Returns text from any specified value
var :: VAR :: **Compatibility:** :: Estimates variance based on a sample
var_p :: VAR.P :: **Statistical:** :: Calculates variance based on the entire population
var_s :: VAR.S :: **Statistical:** :: Estimates variance based on a sample
vara :: VARA :: **Statistical:** :: Estimates variance based on a sample, including numbers, text, and logical values
varp :: VARP :: **Compatibility:** :: Calculates variance based on the entire population
varpa :: VARPA :: **Statistical:** :: Calculates variance based on the entire population, including numbers, text, and logical values
vdb :: VDB :: **Financial:** :: Returns the depreciation of an asset for a specified or partial period by using a declining balance method
vlookup :: VLOOKUP :: **Lookup and reference:** :: Looks in the first column of an array and moves across the row to return the value of a cell
vstack :: VSTACK :: **Look and reference:** :: Appends arrays vertically and in sequence to return a larger array
webservice :: WEBSERVICE :: **Web:** :: Returns data from a web service.
weekday :: WEEKDAY :: **Date and time:** :: Converts a serial number to a day of the week
weeknum :: WEEKNUM :: **Date and time:** :: Converts a serial number to a number representing where the week falls numerically with a year
weibull :: WEIBULL :: **Compatibility:** :: Calculates variance based on the entire population, including numbers, text, and logical values
weibull_dist :: WEIBULL.DIST :: **Statistical:** :: Returns the Weibull distribution
workday :: WORKDAY :: **Date and time:** :: Returns the serial number of the date before or after a specified number of workdays
workday_intl :: WORKDAY.INTL :: **Date and time:** :: Returns the serial number of the date before or after a specified number of workdays using parameters to indicate which and how many days are weekend days
wrapcols :: WRAPCOLS :: **Look and reference:** :: Wraps the provided row or column of values by columns after a specified number of elements
wraprows :: WRAPROWS :: **Look and reference:** :: Wraps the provided row or column of values by rows after a specified number of elements
xirr :: XIRR :: **Financial:** :: Returns the internal rate of return for a schedule of cash flows that is not necessarily periodic
xlookup :: XLOOKUP :: **Lookup and reference:** :: Searches a range or an array, and returns an item corresponding to the first match it finds. If a match doesn't exist, then XLOOKUP can return the closest (approximate) match. 
xmatch :: XMATCH :: **Lookup and reference:** :: Returns the relative position of an item in an array or range of cells. 
xnpv :: XNPV :: **Financial:** :: Returns the net present value for a schedule of cash flows that is not necessarily periodic
xor :: XOR :: **Logical:** :: Returns a logical exclusive OR of all arguments
year :: YEAR :: **Date and time:** :: Converts a serial number to a year
yearfrac :: YEARFRAC :: **Date and time:** :: Returns the year fraction representing the number of whole days between start_date and end_date
yield :: YIELD :: **Financial:** :: Returns the yield on a security that pays periodic interest
yielddisc :: YIELDDISC :: **Financial:** :: Returns the annual yield for a discounted security; for example, a Treasury bill
yieldmat :: YIELDMAT :: **Financial:** :: Returns the annual yield of a security that pays interest at maturity
z_test :: Z.TEST :: **Statistical:** :: Returns the one-tailed probability-value of a z-test
ztest :: ZTEST :: **Compatibility:** :: Returns the one-tailed probability-value of a z-test

